metal.png
TILES

0
1
0 0 32 32

1
1
32 0 64 32

2
1
64 0 96 32

3
1
64 32 96 64

4
1
64 64 96 96

5
1
32 64 64 96

6
1
0 64 32 96

7
1
0 32 32 64

8
1
32 32 64 64

9
0
96 0 128 32

10
0
128 0 160 32

11
0
160 0 192 32

12
0
160 32 192 64

13
0
160 64 192 96

14
0
128 64 160 96

15
0
96 64 128 96

16
0
96 32 128 64

17
0
128 32 160 64

18
2
192 0 224 32

19
3
192 32 224 64
END
24 16
-1 -1 -1 -1 -1 -1 -1 -1 -1 -1 -1 -1 -1 -1 -1 -1 -1 -1 -1 -1 -1 -1 -1 -1 
-1 9 10 10 10 10 10 10 10 10 10 10 10 10 10 10 10 10 10 10 10 10 11 -1 
-1 16 9 10 10 10 10 10 10 10 10 10 10 10 10 10 10 10 10 10 10 11 12 -1 
-1 16 16 9 10 10 10 10 10 10 10 10 10 10 10 10 18 10 10 10 11 12 12 -1 
-1 16 16 16 9 10 10 10 10 10 10 10 10 10 10 10 10 10 10 11 12 12 12 -1 
-1 16 16 16 16 9 10 10 10 10 10 10 10 10 10 10 10 10 11 12 12 12 12 -1 
-1 16 16 16 16 16 9 10 10 10 10 10 10 10 10 10 10 11 12 12 12 12 12 -1 
-1 16 16 16 16 16 16 9 10 10 10 10 10 10 10 10 11 12 12 12 12 12 12 -1 
-1 16 16 16 16 16 16 15 14 14 14 14 14 14 14 14 13 12 12 12 12 12 12 -1 
-1 16 16 16 16 16 15 14 14 14 14 14 14 14 14 14 14 13 12 12 12 12 12 -1 
-1 16 16 16 16 15 14 14 14 14 14 14 14 14 14 14 14 14 13 12 12 12 12 -1 
-1 16 16 16 15 14 14 14 14 14 14 14 14 14 14 14 14 14 14 13 12 12 12 -1 
-1 16 16 15 14 14 14 14 14 14 14 14 14 14 14 14 14 14 14 14 13 12 12 -1 
-1 16 15 14 14 14 14 14 14 14 14 14 14 14 14 14 14 14 14 14 14 13 12 -1 
-1 15 14 14 14 14 14 14 14 14 14 14 14 14 14 14 14 14 14 14 14 14 13 -1 
-1 -1 -1 -1 -1 -1 -1 -1 -1 -1 -1 -1 -1 -1 -1 -1 -1 -1 -1 -1 -1 -1 -1 -1 

0 1 1 1 1 1 1 1 1 1 1 1 1 1 1 1 1 1 1 1 1 1 1 2 
7 19 -1 18 18 18 18 18 18 18 18 18 18 18 18 18 18 18 18 18 18 -1 19 3 
7 -1 -1 18 18 18 18 18 18 18 18 18 18 18 18 18 18 18 18 18 18 -1 -1 3 
7 18 18 8 18 18 18 8 18 18 18 8 8 18 18 18 8 18 18 18 8 18 18 3 
7 18 18 18 18 18 18 18 18 18 18 18 18 18 18 18 18 18 18 18 18 18 18 3 
7 18 18 18 18 8 18 18 18 8 18 18 18 18 8 18 18 18 8 18 18 18 18 3 
7 18 18 18 18 18 18 18 18 18 18 18 18 18 18 18 18 18 18 18 18 18 18 3 
7 18 18 8 18 18 18 0 1 1 1 1 1 1 1 1 2 18 18 18 8 18 18 3 
7 18 18 8 18 18 18 6 5 5 5 5 5 5 5 5 4 18 18 18 8 18 18 3 
7 18 18 18 18 18 18 18 18 18 18 18 18 18 18 18 18 18 18 18 18 18 18 3 
7 18 18 18 18 8 18 18 18 8 18 18 18 18 8 18 18 18 8 18 18 18 18 3 
7 18 18 18 18 18 18 18 18 18 18 18 18 18 18 18 18 18 18 18 18 18 18 3 
7 18 18 8 18 18 18 8 18 18 18 8 8 18 18 18 8 18 18 18 8 18 18 3 
7 -1 -1 18 18 18 18 18 18 18 18 18 18 18 18 18 18 18 18 18 18 -1 -1 3 
7 19 -1 18 18 18 18 18 18 18 18 18 18 18 18 18 18 18 18 18 18 -1 19 3 
6 5 5 5 5 5 5 5 5 5 5 5 5 5 5 5 5 5 5 5 5 5 5 4 
